# 国际化按字典顺序排序
about=关于
actualSize=实际尺寸
add=新增
addLayer=新增图层
addProperty=新增属性
addToExistingDrawing=添加到已有画面
addWaypoint=新增航点
advanced=高级图形
align=对齐
alignment=对齐
allChangesLost=所做的修改将会丢失！
alreadyConnected=连接已经存在
angularGauge=速度仪
apply=应用
arc=Arc
arrange=布局
arrow=箭头
arrows=箭头
automatic=自动
autosave=自动保存
autosize=自动调整

background=背景
backgroundColor=背景颜色
backgroundImage=Background Image
basic=基本图形
block=块
blockquote=块引用
bold=粗体
borderColor=边框颜色
borderWidth=边框宽度
bottom=下
bottomAlign=下对齐
bottomLeft=Bottom Left
bottomRight=Bottom Right
bulletedList=项目符号列表

cancel=取消
cannotOpenFile=Cannot open file
center=垂直居中
change=Change
changeOrientation=改变方向
circle=圆
classic=经典
clearCache=清除缓存
clearDefaultStyle=Clear Default Style
clearWaypoints=清除航点
clipart=剪贴画
close=关闭
collapse=折叠
collapseExpand=折叠/扩展
collapse-expand=折叠/展开
collapsible=可折叠
comic=Comic
connect=连接
connection=连接
connectionArrows=连接箭头
connectionPoints=连接点
constrainProportions=Constrain Proportions
containsValidationErrors=验证错误
copy=复制
copyConnect=副本连接
copyMultipleTableGuidance=复制多表向导...
copySingleTableGuidance=复制单表向导...
coreObj=核心对象
create=创建
createDatabaseConnectionGuidance=创建数据库连接向导...
curved=弯曲
custom=自定义
cut=剪切

dashed=虚线
database=数据库
debug=调试
decreaseIndent=减少缩进
default=Default
delete=删除
deleteColumn=删除列
deleteRow=删除行
diagram=图表
diamond=菱形
diamondThin=菱形（细）
direction=方向
distribute=分布
document=文档
divider=Divider
documentProperties=Document Properties
done=完成
dotted=Dotted
doubleClickOrientation=双击改变方向
drawing=画面
drawingEmpty=画面为空
drawingTooLarge=画面太大
duplicate=复本
duplicateIt=Duplicate {1}

east=东
edit=编辑
editData=编辑数据
editDetails=编辑
editDiagram=Edit Diagram
editImage=编辑画面
editLink=编辑链接
editStyle=编辑样式
editTooltip=编辑提示
enterGroup=加入组合
enterName=输入名称
enterPropertyName=输入属性名
enterValue=输入数值
entityRelation=实体关系
ep_database=数据库
ep_label=步骤名称
error=错误
errorSavingFile=Error saving file
execution=执行
exitGroup=退出组合
expand=扩展
export=导出
exportRepository=导出资源库
extras=其他

file=文件
filename=文件名
fileNotFound=文件没有找到
fill=Fill
fillColor=填充颜色
fitPage=单页
fitPageWidth=页面宽度
fitTwoPages=双页
fitWindow=适应窗口
flip=Flip
flipH=水平镜像
flipV=垂直镜像
font=Font
fontColor=字体颜色
fontFamily=字体
fontSize=字体大小
format=格式
formatGif=GIF
formatJpg=JPEG
formatPanel=Format Panel
formatPdf=PDF
formatPng=PNG
formatSvg=SVG
formatted=格式化
formattedText=格式化文本
formatXml=XML

gap=Gap
general=通用
glass=Glass
global=整体间距
gradient=渐变
gradientColor=渐变色
grid=网格
gridSize=Grid Size
group=组合
guidance=向导
guides=指导

heading=标题
height=高度
help=帮助
hidden=隐藏
hide=隐藏
hideIt=隐藏 {1}
history=历史
home=Home
horizontal=水平
horizontalFlow=水平流
horizontalTree=水平树
html=HTML

image=图片
images=图片
import=导入
importRepository=导入资源库
increaseIndent=增加缩进
inputPaletteText=输入
insert=插入
insertColumnAfter=在右边插入列
insertColumnBefore=在左边插入列
insertHorizontalRule=插入水平线
insertImage=插入图片
insertLink=插入链接
insertRowAfter=在下方插入行
insertRowBefore=在上方插入行
invalidName=无效名称
invalidOrMissingFile=文件无效或者已丢失
isometric=Isometric
italic=斜体

jobMeasure=作业度量

landscape=景观
laneColor=Lanecolor
layers=分层
layout=布局
left=左
leftAlign=左对齐
leftToRight=Left to Right
line=线
lineend=终点箭头
lineheight=Line Height
lineJumps=Line jumps
linestart=起点箭头
linewidth=线条宽度
link=Link
loading=加载中
lockUnlock=锁定/解锁
log=日志

mainObjTree=主对象树
manual=手动
middle=水平居中
misc=Misc
more=更
moreResults=More Results
move=移动
moveSelectionTo=将选择移动到 {1}

navigation=导航
new=新建
noColor=没有颜色
noFiles=没有文件
noMoreResults=No more results
none=无
noResultsFor=No results for '{1}'
normal=通用
north=北
numberedList=编号列表

ok=确认
opacity=不透明
open=打开
openArrow=开放箭头
openFile=打开文件
openInNewWindow=在新的窗口中打开
openInThisWindow=Open in this Window
openLink=打开链接
openSupported=支持的格式为该软件保存的.xml文件
options=选项
organic=有机
orthogonal=正交
outline=缩略图
outputPaletteText=输出
oval=椭圆形

pages=页面
pageScale=页面范围
pageSetup=页面设置
pageView=页面视图
paintProperties=填充属性
paperSize=页面大小
paste=粘贴
pasteHere=粘贴
pattern=Pattern
pause=暂停
perimeter=Perimeter
placeholders=Placeholders
plusTooltip=Click to connect and clone (ctrl+click to clone, shift+click to connect). Drag to connect (ctrl+drag to clone).
portrait=人像
position=位置
posterPrint=海报打印
preview=视图
print=打印

radialTree=径向树
redo=重做
removeFormat=清除格式
removeFromGroup=从组合中移除
removeIt=移除 {1}
removeWaypoint=移除航点
rename=重命名
renameIt=重命名 {1}
replace= {1} 已经存在，是否替换？
replaceExistingDrawing=替换已经存在的画面
replaceIt={1} already exists. Do you want to replace it?
reset=重置
resetView=重置视图
resourceLibrary=资源库
resultpanel=显示/隐藏执行结果面板
reverse=反转
right=右
rightAlign=右对齐
rightToLeft=Right to Left
rotate=旋转
rotateTooltip=Click and drag to rotate, click to turn by 90 degrees
rotation=旋转
rounded=圆角
run=运行
runOption=运行选项

save=保存
saveAs=保存为
saved=已保存
scan=浏览
scrollbars=滚动条
search=搜索
searchShapes=搜索图形
selectAll=全选
selectEdges=选择边缘
selectFont=选择字体
selectNone=取消选择
selectVertices=选择顶点
setAsDefaultEdge=设置为默认的边缘
stepMeasure=步骤度量
shadow=阴影
shape=形状
sharp=Sharp
sidebarTooltip=Click to expand. Drag and drop shapes into the diagram. Shift+click to change selection. Alt+click to insert and connect.
simple=Simple
simpleArrow=Simple Arrow
size=大小
solid=Solid
sourceSpacing=源间距
south=南
spacing=间距
stop=终止
straight=直线
strokeColor=线条颜色
style=风格
subscript=子脚本
superscript=超级脚本

table=表格
tableInput=表输入
tableInputTip=tableInputTip
tableOutput=表输出
tableOutputTip=tableOutputTip
targetSpacing=目标间距
text=文本
textAlignment=文字对齐
textOpacity=文字不透明度
toBack=向下
toFront=向上
tools=工具
tooltips=提示
top=上
topAlign=上对齐
topLeft=Top Left
topRight=Top Right
transparent=透明
turn=旋转 90°

UML=UML
underline=下划线
undo=复原
ungroup=取消组合
untitledLayer=Untitled Layer
updatingDocument=更新文件中，请稍后......
updatingSelection=更新选项中，请稍后......
url=URL

vertical=垂直
verticalFlow=垂直流
verticalTree=垂直树
view=视图

waypoints=Waypoints
west=西
width=宽度
wordWrap=自动换行
writingDirection=Writing Direction

zoom=缩放
zoomIn=放大
zoomOut=缩小
